HannahHorowitz	Night	Neat	MadelineHession			
RiddhiSoni	Morning	Messy	None			
LaurenLawson	Night	Messy	None			
GillianSmeaton	Night	Neat	None			
JosieBauer	Morning	Neat	None			
MadelineHession	Morning	Neat	None			
SamBennett	Morning	Neat	None			
ClaireFranksen	Night	Neat	JosieBauer			
RebeccaHeinert	Night	Neat	None			
ShelbyMattix	Morning	Messy	None			
MichelleTrumble	Morning	Neat	None			
CourtneyPolka	Night	Messy	None			
JaneDoe	Night	Messy	ShelbyMattix			
JaneRoe	Night	Neat	HannahHorowitz			
PeggyMcDonald	Morning	Neat	None			
MaddiePop	Night	Neat	None			
AnnaStar	Morning	Messy	None			
LauraRed	Morning	Messy	LivSmith			
LivSmith	Morning	Messy	LauraRed			
DrakeBell	Morning	Messy	None			
JoshPeck	Morning	Messy	None			
SteveMadden	Night	Neat	None			
CalvinKlein	Night	Neat	JohnDoe			
EmmaRose	Morning	Messy	None			
JordanTulip	Night	Neat	LivSmith			
ShelbyMatrix	Morning	Messy	None			
RileySampson	Morning	Neat	None			
JoAnnSilver	Night	Neat	None			
ShellyVee	Morning	Neat	None			
JamesMarch	Night	Messy	None			
JoeApril	Night	Neat	None			
JordanGee	Night	Neat	None			
JordanGo	Morning	Messy	None			
LeahBlader	Night	Neat	None			
DonJoe	Night	Messy	JordanGee			
KateSpade	Morning	Neat	None			
ElleBlue	Night	Messy	None			
PatrickKleen	Morning	Messy	LeahBlader			
PatrickClone	Night	Neat	None			
MadyAnglim	Night	Neat	None			
EmmaThoreson	Night	Messy	None			
SydneySampson	Night	Messy	None			
GraceOrella	Morning	Messy	None			
PhelpsHawley	Morning	Messy	None			
GabrielleGriffith	Morning	Neat	None			
RonniWinn	Night	Neat	AspenWalters			
DarbyHolroyd	Morning	Neat	None			
CourtneyClapper	Night	Neat	None			
AnnabelleStroud 	Morning	Neat	None			
KailiMiller	Morning	Neat	None			
AspenWalters	Night	Messy	None			
EmilyKellogg	Night	Messy	None			
BraedenMcElmury	Night	Messy	None			
MicaelaHarris	Night	Neat	None			
MadiKoetting	Morning	Neat	None			